#####################
#         #         #
# ## #### # #### ## #
#                   #
# ## # ####### # ## #
#    #    #    #    #
#### #### # #### ####
   # #         # #   
#### # ###-### # ####
       #PI BC#       
#### # ####### # ####
   # #         # #   
#### # ####### # ####
#         #         #
# ## #### # #### ## #
#  #      @      #  #
## # # ####### # # ##
#    #    #    #    #
# ####### # ####### #
#                   #
#####################
`