#####################
#         #         #
# ## #### # #### ## #
#                   #
# ## # ####### # ## #
#    #    #    #    #
#### #### # #### ####
#### #         # ####
#### # ### ### # ####
       #PI~BC#       
#### # ####### # ####
#### #         # ####
#### # ####### # ####
#         #         #
# ## #### # #### ## #
#  #      @      #  #
## # # ####### # # ##
#    #    #    #    #
# ####### # ####### #
#                   #
#####################